XXXXXX
X    X
X  XXX
X  XOX
X    X
XXXXXX